11111111111111111111111111111111111111111111111111
11111111111111111111111111111111111111111111111111
11111111111111111111111111111111111111111111111111
1111111111111111111111111E111111111111111111111111
11110000011000000001110002000000000000000111111111
11110000111000000001110002000000000000000111111111
11110000110000110001110002000000000000000011111111
11110000110000110001110002222000000000000011111111
11110000100000110000110000000000000000000011111111
11110000000000000000011111111111111100000011111111
11110000000000000000000000000000111111000001111111
11110000000000000000000000000000000111100000111111
11110000000001111100000000000000000000110000001111
11110001110001111111111111111000000000001000001111
11110001110001100000000001111100000000001000001111
11110000000001110000000000011111000000011000001111
1111000000000111100001000001111110000111100001111
11111111100000111100000000000011111111111000111111
11111111110000011110000000000000111111110000111111
11110000001000000111100000000000000000000000111111
11110000000100000011110000000000000000000000111111
111E2222000110000001111000000000000000000000001111
11110000000111000000111110000001111111111100001111
11110000011111100000011111000001111111111110001111
11110000111001110000000111000000000000000111001111
11110000110000111000000011000000000011000011101111
11110000110000011100000000000000000011000001111111
11110000110000001110000000000000000000000000111111
11110000110000000111000000000000000000000000111111
11110000110000000011101111111111111100000000111111
11110000110001110001111111111111111110000000111111
11110000110000111000111111111111111110000000001111
11110000111000011100011111111111111110000000001111
11110000011100001110001111111111111100000001001111
11110000001110000111000000000000000001000011001111
11110000000110000011100000000000000000000111001111
11110000000000000001110000001111000000001110001111
11110000000000010001110000001111000000001110001111
11110000010000000001111000000000000000011100001111
11111111111111111111111111111111111111111111111111
11111111111111111111111111111111111111111111111111
11111111111111111111111111111111111111111111111111
11111111111111111111111111111111111111111111111111