111111111111111111111111111111111111111111111
111111111111111111111111111111111111111111111
111111111111111111111111111111111111111111111
1111111111111111111111E1111111111111111111111
111111111000000000000020000000000000111111111
111111110000000000000020000000000000011111111
111111110000000000000020000000000000011111111
111111100000000000000020000000000000001111111
111111000022222222222222222222222220000111111
111110000220000000000000000000000022000011111
111100000200000000000000000000000002000001111
111100000200011111111111111111110002000001111
111100000200011111111111111111110002000001111
111100000200011111111111111111110002000001111
111100000200000011111111111110000002000001111
111100000200000000011111110000000002000001111
111100000200000000000000000000000002000001111
111100000220000000000000000000000022000001111
111100000022222222222222222222222220000001111
111111000000000222000020000222000000000111111
111111110000000022000020000220000000011111111
111111111100000022200020002220000001111111111
111100000000000222222222222222000000000001111
111100000000002200000000000002200000000001111
111100000222222000000000000000222222000001111
111100002200000000111111111000000002200001111
111E2222220000000011111111100000000022222E111
111100002200000000111111111000000002200001111
111100000222222000000000000000222222000001111
111100000000002200000000000002200000000001111
111100000000000222222222222222000000000001111
111111111100000022200020002220000001111111111
11111111000000002200002000022000000001111111
111111000000000222000020000222000000000111111
111100000022222222222222222222222220000001111
111100000220000000000000000000000022000001111
111100000200000000000000000000000002000001111
111100000200000000011111110000000002000001111
111100000200000011111111111110000002000001111
111100000200011111111111111111110002000001111
111100000200011111111111111111110002000001111
111100000200011111111111111111110002000001111
111100000200000000000000000000000002000001111
111110000220000000000000000000000022000011111
111111000022222222222222222222222220000111111
111111100000000000000020000000000000001111111
111111110000000000000020000000000000011111111
111111110000000000000020000000000000011111111
111111111000000000000020000000000000111111111
1111111111111111111111E1111111111111111111111
111111111111111111111111111111111111111111111
111111111111111111111111111111111111111111111
111111111111111111111111111111111111111111111