1111111111111111111111111111111111111111111
1111111111111111111111111111111111111111111
1111111111111111111111111111111111111111111
1111111111111111111111111111111111111111111
1111000000000000000011100000000000000001111
1111000000000000000000000000000000000001111
1111001100000000011000001100000011111001111
1111001110000000011000001100000011111001111
1111000111110000000111110000000011111001111
1111000011111000000111110000000011111001111
1111000000011100000000000000000011111001111
1111000000001110000000000001100000000001111
1111000000001110000000000001100000000001111
1111000000000111111100000011100000002001111
1111000000000011111110000111000001002001111
1111111111000000000110001110000001002001111
1110000001000000000011111100000001002000111
1110000001000000000011111100000001002000111
111E22200100110000111111100001100100222E111
1110002001001100011111100000011001000000111
1110002001001100011111100000011001000000111
1111002001000000111000110000000001111111111
1111002001000001110000111111100000000001111
1111002000000011100000011111110000000001111
1111000000000011000000000000111000000001111
1111000000000011000000000000111000000001111
1111001111100000000000000000011100000001111
1111001111100000000111110000001111100001111
1111001111100000000111110000000111110001111
1111001111100000011000001100000000111001111
1111001111100000011000001100000000011001111
1111000000000000000000000000000000000001111
1111000000000000000011100000000000000001111
1111111111111111111111111111111111111111111
1111111111111111111111111111111111111111111
1111111111111111111111111111111111111111111
1111111111111111111111111111111111111111111