111111111111111111111111111111111
111111111111111111111111111111111
111111111111111111111111111111111
111111111111111111111111111111111
111100000000000000000000000001111
111100000000000000000000000001111
111100000000000111000000000001111
111100000100000111000000000001111
111111111111100111001111111001111
111100000000100000001000000001111
111100000000100000001000000001111
111100011100111000111001110001111
111100000100101000101001000001111
111100000100111000111001000001111
111100100111110000011111001001111
111100000001100000001100000001111
111100000011000010000110000001111
111100020010000111000010020001111
111E2222001000111110001002222E111
111100020010000111000010020001111
111100000011000010000110000001111
111100000001100000001100000001111
111100000111110000011111001001111
111100000100111000111001000001111
111100000100101000101001000001111
111100111100111000111001110001111
111100000000100000001000000001111
111100000000100000001000000001111
111100011111100111001111111111111
111100000000000111001001000001111
111100000000000111000000000001111
111100000000000000000000000001111
111100000000000000000000000001111
111111111111111111111111111111111
111111111111111111111111111111111
111111111111111111111111111111111
111111111111111111111111111111111