               1
              111
             11111
            1111111
           1111E1111
          11110201111
         1110002000111
        111100020001111
       11110000200001111
      1111000002000001111
     111100000020000001111
    11110011100200111001111
   1111001000002000001001111
  111100010000020000010001111
 11110000100222222200100001111
1111000001002000002001000001111
11110000010020FFF02001000001111
11110000010020FFF02001000001111
11110000010020FFF02001000001111
1111000001002000002001000001111
 11110000100222222200100001111
  111100010000020000010001111
   1111001000002000001001111
    11110011100200111001111
     111100000020000001111
      1111000002000001111
       11110000200001111
        111100020001111
         1110002000111
          11110201111
           1111E1111
            1111111
             11111
              111
               1
