11111111111111111111111111111111111111111111111
11111111111111111111111111111111111111111111111
11111111111111111111111111111111111111111111111
11111111111111111111111E11111111111111111111111
11110000000000000110000200001100000000000001111
11110000000111100011000200011000111100000001111
11110010000000100001100200110000100000001001111
11110000000001100000100200100000110000000001111
11111100010011000111100200111100011001000111111
11110000010110001100000200000110001101000001111
11110010011100011000002220000011000111001001111
11110010000000110000022222000001100000001001111
11110000000001100000200000200000110000000001111
11110000000011100000000000000000111000000111111
11110000000110111000000000000011101100000001111
11110010001100001000000000000010000110001001111
11110000011000001110000000001110000011000001111
11110000000000000010000000001000000000000001111
111E222200001100001110000011100001100002222E111
11110000000111100000100000100000111100000001111
11110000000000000000110001100000000000000001111
11110010000000000000010001000000000000001001111
11110000001000010000110001100001000010000001111
11111100001100110001100000110001100110000111111
11110000000111100011000000011000111100000001111
11110010000011000110000100001100011000001001111
11110010000000001100001110000110000000001001111
11110000000000011000011011000011000000000001111
11111100000000110000110001100001100000000111111
11110000000001100001100000110000110000000001111
11110010000000000000110001100000000000001001111
11110000000000000000000000000000000000000001111
11110000000011110000000000000001111000000001111
11111111111111111111111111111111111111111111111
11111111111111111111111111111111111111111111111
11111111111111111111111111111111111111111111111
11111111111111111111111111111111111111111111111