111111111111111111111111111111111
111111111111111111111111111111111
111111111111111111111111111111111
111111111111111111111111111111111
111100000000000000000000000001111
111100000000000110000000000001111
111100000000000110000000000001111
111100000000000000000000000001111
111100001111000000000000000111111
111100001111000000000000001111111
111100000000000000000000011001111
111100000000000011100000110001111
111100011110000000000001100001111
111100011110000000000011000001111
111100000000000000000110000011111
111100000000000000001100000011111
111100000000000000011000000001111
111100020000001000110000020001111
111E2222000000100010000002222E111
111100020000001000100000020001111
111100000000011000000000000001111
111100000000110000000000000001111
111100000001100000000111100001111
111100000011000000000111100001111
111100000110000000000000000001111
111100001100000111100000000001111
111100011000000111100000000001111
111100110000000000000011110001111
111111100000000000000011110001111
111111000000000222000000000001111
111100000000000020000000000001111
111100000000000020000000000001111
111100000000000020000000000001111
1111111111111111E1111111111111111
111111111111111111111111111111111
111111111111111111111111111111111
111111111111111111111111111111111