1111111111111111111E11111
1000000000000000000000001
1000000000000000000000001
1000333000000000003330001
1000333000033300003330001
1000333000033300003330001
1000333000033300003330001
1000333000000000003330001
1000000000000000000000001
1000000000000000000000001
11111E1111111111111111111