1111111111E1111111111
100000000000000000001
103330000000000033301
103000000000000000301
103000000000000000301
100000000030000000001
100000000333000000001
E0000000333330000000E
100000000333000000001
100000000030000000001
103000000000000000301
103000000000000000301
103330000000000033301
100000000000000000001
1111111111E1111111111