1111111111111111111111111
1000000000000000000000001
1003330333000003330333001
1003000003000003000003001
1003000003000003000003001
1003330333000003330333001
1000033300000000033300001
1000003000000000003000001
1000000000000000000000001
111111111111E111111111111