111E111
1000001
1000001
1000001
1000001
1000001
1000001
1000001
1000001
1000001
1000001
1000001
1000001
1000001
1000001
1000001
1000001
1000001
1000001111111111111111111
1000000333333330000000001
1000000333333330000000001
100000000000000000000000E
1000000333333330000000001
1000000333333330000000001
1111111111111111111111111