1111111111111111111111111
1000000000000000000000301
1033333333333333333333301
1000000000003000000000001
E00333333330303333333330E
1003000000000000000000301
1003333333333333333333301
1003000000000000000000001
1111111111111111111111111
