11111E1111111111111111111
1000000000000030000000001
1000000000000030000000001
1000000330000030003333001
1000000330000030003000001
1000000000000030003003331
133000000000003000300300E
1330000003300000003000001
1000000003300030003333331
1000000000000030000000001
11111E1111111111111111111