11111111
13333331
13333331
133SS331
133SS331
10000001
10000001
111E1111