1111111111111
1333333333331
1333333333331
133P00F00000E
1330000000001
1330000000001
1330000000001
1330000000001
1330000000001
1330000000001
1330000000001
1330000000001
111E111111111