11111111111111111111111111111111111111111111
10000000000300000000003330000003330000000001
10000000000300000000003330000003330000000001
10000000000300000000003330000000000000000001
10000000000300000000003330000000000000000001
10000000000300000000003330000003330000000001
10000000000300000000003330000003330000000001
10000000003330000000003330000003330000000001
10033300000000000000003330000003330000000001
10033300000000000000000000000003330000000001
10033300000000000000003330000003330000000001
10033300000000000000003330000003330000000001
100333000000P0000000003330000003330000000001
10033300000000000000003330000003330000000001
10033333333333033333333330000003333333333331
10033333333333033333333330000003333333333331
10033300000000000000000000000000000000000001
10033300000000000000000000000000000000000001
10033300333333333333333333333333333333333331
10033300333333333333333333333333333333333331
10033300000000000000000000000000000000000001
10033300000000000000000000000000000000000001
10033300000000000000000000000000000000000001
10033300000000000000000000000000000000000001
10033333333333333333333333333333333333333331
10033333333333333333333333333333333333333331
10000000000000000000000000000000000000000001
10000000000000000000000000000000000000000001
10000000000000000000000000000000000000000001
10000000000000000000000000000000000000000001
10000000000000000000000000000000000000000001
10000000000000000000000000000000000000000001
10000000000000000000000000000000000000000001
11111111111111111111111111111111111111111111